################################
|         %                    |
|         %                    |
|         %                    |
|         %          %         |
|                    %         |
|                    %%%%%%%%%%|
|                              |
|                              |
|         %%%%%%%%%%           |
|                              |
|                              |
|                              |
|                              |
################################